NO ./textures/north.xpm

SO ./textures/south.xpm

WE ./textures/west.xpm


EA ./textures/east.xpm

F 50,50,40

C 20,25,51

        1111111111111111111111111
        1000000000110000000000001
        1111111111110000000000001
        1001000000000000000000001
111111111011000001110000000000001
100000000000000001110111111111111
1111011111111101110000000000001
1111011111111101110101001000001
1100000011010101110000001000001
11111111100000000000000001000001
        1000000000110000000000001
        1111111111110000000E00001
        1001000000000000000000001
111111111011000001110000000000001
100000000000000001110111111111111
1111011111111101110000000000001
1111011111111101110101001000001
1100000011010101110000001000001
1000000000000000000000001000001
1000000000000000110101001000001
11000001110101011111011110000011
11110111 1110101 10111101000001
11111111 1111111 11111111111111
