NO      ./textures/north.xpm

SO      ./textures/south.xpm

WE      ./textures/west.xpm

EA      ./textures/east.xpm

F 80,10,40

C 54,188,253

11111111111111111111111111111111111
        1000000001100000000000011
        1111111111110000000000001
        1001000000000000000000001
111111111011000001110000000000001
100000000000000001110111111111111
111101111111110111000000000000101
111101111111110111010100100100101
1100000011110101110000001011100111
11111111110000000000001001000001
11111111111111111111111111111111
100000000111100000000001110011111111
111111111111100000001111111111
111111111111 100001111 101110111111111111111
111101111 111111011101111001000001111
110000001101010111000000100000111
1000000000000000000000001000001
10000000000000001101010010000011
11000001110101100111110111100N0011
11110111111010111  1111010000011
1111111111111111   111111111111
11111111111111111111111111111111
