NO      ./textures/north.xpm

SO      ./textures/south.xpm

WE      ./textures/west.xpm

EA      ./textures/east.xpm

F 80,10,40

C 54,188,253

1111111111111111111111111111111111
		100000000110000000000001
        1111111111110000000000001
        1001000000000000000000001
111111111011000001110000000000001
100000000000000011101W1111111111
111101111111110111000000000000101
111101111111110111010100100100101
1100000011110101110000001011100111
11111111111111111111111111111111
10000000011110000000000110011111111
111111111111100000001111111111
111111111111 100001111 101110111111111111111
11101111 111111011101111001000001111
110000001101010111000000100000111
100000000000000000000000100001
1000000000000000110101001000011
110000011101011011111101111000011
1111011111101011   1111010000011
1111111111111111   111111111111
