NO ./textures/north.xpm

SO ./textures/south.xpm

WE ./textures/west.xpm


EA ./textures/east.xpm

F 211,211,207

C 41,41,41

        1111111111111111111111111
        1000000000110000000000001
        1111111111110000000000001
        1001000000000000000000001
111111111011000001110000000000001
100000000000000001110111111111111
1111011111111101110000000000001
1111011111111101110101001000001
1100000011010101110000001000001
111111111000000000000E0001000001
1000000000110000000000001111111
1111111111110000000000001
10010000000000000000000011111111
111111111011000001110000000000001
100000000000000001110111111111111
1111011111111101110000000000001
1111011111111101110000000000001
1111011111111101110000000000001
1111011111111101110000000000001
1111011111111101110000000000001
1111011111111101110000000000001
1111011111111101110000000000001
1111111111111111111111111111111
